Pilnwarneeku wehleschanas Walzts Domes
wehletaju sapulcem Widzemē.
Allaschos — Grunduļu Augusts Ahboliņsch un Wez-&gt;tlinschu Brenzis Baumanis.
B i h ri ņ o s — Wehmeru Ernests ŞchulzS un Jaunischkalnu KrischjahnS MejerS.
W i dri scho S — Ganiņu RichardS RositS un Şchķuhşchu Jahnis Steins.
Şiguldâ — Roķenu Jahnis Grunb ergs un Wez-Koşchu KarliS Kreilis.
Lehdurgâ — Juglu Jahnis Brants un Tilgaļu Frizis Trejs.
Nurm işcho S — RatncA» Rūdolfs LaubertS un Tuhtapu PeterS Ahboliņsch.
PabaschoS — Mahrtiņşch lanşonSun Karlis E se – r iņsch.
Pa l t m a l ê — Kumodu Jahnis U p i t S un Dodu Jahnis P c l ka w S.
Şkultê — Leel-urogsemu KarliS Behrsiņsch un Lejas-Stepu Miķelis Gruhba.
Jntşchukalnâ — Milķertu Gusts MuischneekS un Lihzischu PeterS Lasdiņsch.
Şe h j â — Ģiķenu Juris S eedi ņ ş ch un Şuhzu Jahnis E g l i t s.
Plahterê — Plauschu Jahnis Kalniņşch un Wez-Zaunu Miķelis I a v no s o l i ņ ş ch.
Aeipenê — Wanagu Karlis Steebriņşch un Meln-Ģibuļu Karlis Baltiņşch.
ŞuntaschoS — Muzeneeku Jahnis WabuliS un Jndiņu Jahnis Raşiņşch.
Nitaurē — Purwiņu Eduards Skuja un Lejas-Kuilenu Karlis Gaili ts.
AderkaşchoS — Şpehļu Jahnis Leepiņşch un Jurenu Juris AndriksonS.
Jaunpili — Ņemnaudu Karlis Ausinşch un Duhrjahņu Andrejs A pa lups.
Kastranê — Weeglaju Jahnis Ausiņşch un Kreiļu Jahnis Romānis.
Rikterê — Gramu Jahnis Piliņşch un Pēteris Frei manis.
Ch rģe mê — StelteS I. Şkuja un SihleS I. MirkşlchS.
Mehdsulê — AnşonS un Kruhmiņşch.
Drustos — Wez-Perļu I. Perlbachs un Semeru I. Lahzis.
Äehtşchos — Aehtşchu pagasta wezakà palihgi Jahnis Kalniņşch un karlis EglitS.
Weişm a ņ o s — şaimneeki karlis Berkh o l z S un Damids Libberts.
PlahņoS — şaimneeki Augusts Goppertsun JahniS Reinş o n S.
Mahl'upê — A. Pelezs un A. Krustiņşch.
Aumeisteros — LejaS-Muzenceku P. EglitS un Lejas-Mangaļu I. ŞarkangalwiS.
LejaSzeemâ — pagasta mezakais JahniS Gailis un Grabaschu şkolaS şiolotajS Krustiņsch FranziS.
Wez-Şalazâ — Mesch-Kadagu mahju ihpaschneekS LaimaşarS un Kestem rentneeks AnderşonS.
Neşanahzis wajadşigais mehletaju şiaits un delegāti neeemehleti: Mores, Mahlpils, Krimuldas, Turaidas, Kahrķu, Golgowşkas un BehrfoneSpagastoS.
Maso semcs ihpaschneeku pilnmarneeku mehleschanas Widsemê nam notikuşchas RigaS, Malmeeras, Zehşu, WalkaS, TerbataS, WilandeS, Pernamas un Şahmu şalaS apriņķos, jo neweenS mehletajs nebijis eeradeeS. Tikai WilandeS aprinķ? eeraduscheeS 1 mahzitajS un 1 muischneeks, kas eemehleti.