Pilnvarneeku vēlešanas Valcts Domes
vēletaju sapulcem Vidcemē.
Allašos — Grunduļu Augusts Āboliņš un Vec-&gt;tlinšu Brencis Baumanis.
B i h ri ņ o s — Vēmeru Ernests Şchulcs un Jauniškalnu Krišjāns Mejers.
V i dri šo s — Ganiņu Richardz Rosits un Şchķūšu Jānis Steins.
Şiguldā — Roķenu Jānis Grunb ergs un Vec-Košu Karlis Kreilis.
Lēdurgā — Juglu Jānis Brants un Tilgaļu Fricis Trejs.
Nurm išo s — RatncA" Rūdolss Lauberts un Tūtapu Peters Āboliņš.
Pabašos — Mārtiņš lansonSun Karlis E se – r iņš.
Pa l t m a l ē — Kumodu Jānis U p i t s un Dodu Jānis P c l ka v s.
Şkultē — Liel-urogsemu Karlis Bērsiņš un Lejas-Stepu Miķelis Grūba.
Jnčukalnā — Milķertu Gusts Muišneeks un Līcišu Peters Lasdiņš.
Şe h j ā — Ģiķenu Juris s iedi ņ s ch un Şūcu Jānis E g l i t s.
Plāterē — Plaušu Jānis Kalniņš un Vec-Caunu Miķelis I a v no s o l i ņ s ch.
Aeipenē — Vanagu Karlis Stiebriņš un Meln-Ģibuļu Karlis Baltiņš.
Şuntašos — Muceneeku Jānis Vabulis un Indiņu Jānis Rasiņš.
Nitaurē — Puwiņu Eduardz Skuja un Lejas-Kuilenu Karlis Gaili ts.
Aderkašos — Şpēļu Jānis Liepiņš un Jurenu Juris Andriksons.
Jaunpili — Ņemnaudu Karlis Ausinš un Dūrjāņu Andrejs A pa lups.
Kastranē — Vieglaju Jānis Ausiņš un Kreiļu Jānis Romānis.
Rikterē — Gramu Jānis Piliņš un Pēteris Frei manis.
Ch rģe mē — Steltes I. Şkuja un Sīles I. Mirkslchs.
Mēdsulē — Ansons un Krūmiņš.
Drustos — Vec-Perļu I. Perlbachs un Semeru I. Lācis.
Äēčos — Aēču pagasta vecakā palīgi Jānis Kalniņš un karlis Eglits.
Veism a ņ o s — saimnieki karlis Berkh o l c s un Damidz Libberts.
Plāņos — saimnieki Augusts Goppertsun Jānis Reins o n s.
Māl'upē — A. Pelecs un A. Krustiņš.
Aumeisteros — LejaS-Mucenceku P. Eglits un Lejas-Mangaļu I. Şarkangalvis.
LejaSciemā — pagasta vecakais Jānis Gailis un Grabašu skolas siolotajs Krustiņš Francis.
Vec-Şalacā — Meš-Kadagu māju īpašneeks Laimasars un Kestem rentneeks Andersons.
Nesanācis vajadsigais mēletaju siaits un delegāti neiemēleti: Mores, Mālpils, Krimuldas, Turaidas, Kārķu, Golgovskas un BērsoneSpagastos.
Maso semcs īpašneeku pilnmarneeku mēlešanas Vidsemē nav notikušas Rigas, Malmieras, Cēsu, Valkas, Terbatas, Vilandes, Pernamas un Şāmu salas apriņķos, jo neviens mēletajs nebijis ieradies. Tikai Vilandes aprinķ? ieradušies 1 mācitajs un 1 muišneeks, kas iemēleti.